40 20
########################################
#                                      #
#    ##     #     #  #   #####         #
#   #      # #   # ## #  #             #
#   #     #   #  #    #  ####          #
#   # ##  # # #  #    #  #             #
#    ##   #   #  #    #  #####         #
#                                      #
#                                      #
#       #    #    #    ###    #    #   #
#       #   # #   #   #   #  # #   #   #
#       #  #   #  #   #   #  #  #  #   #
#       # #     # #   #   #  #   # #   #
#        #       #     ###   #    #    #
#                                      #
#                                      #
#                                      #
#                                      #
#                  @                   #
########################################
